NO ./textures/north.xpm
SO ./textures/south.xpm
WE ./textures/west.xpm
EA ./textures/east.xpm
F 30,30,30
C 60,60,60


















11111
1N001
10001
11111


