   WE                            textures/west.xpm
NO textures/north.xpm



SO textures/south.xpm

F     30,   30,     30

EA textures/east.xpm
C 60, 60, 60




1111111111111111111111111
10S01100001000000000000011111111
1000110000000000111111001      1
10001100000000001100010011    11
1000000000100000000001001
1111111111111111111111111
