NO ./textures/north.xpm
SO ./textures/south.xpm
WE ./textures/west.xpm
EA ./textures/east.xpm

F 12,34
C 1,2,3

11111111111111111111
10000000000000000001
10100000001100000001
10000000000000000001
11110111101111101111
10000100001000010001
11110111101111101111
1000000000N000000001
11111111111111111111