NO ./textures/north.xpm
SO ./textures/south.xpm
WE ./textures/west.xpm
EA ./textures/east.xpm
F 10,20,30
C 200,210,220

11111
1N0S1
10001
11111
