NO ./textures/north.xpm
SO ./textures/south.xpm
WE ./textures/west.xpm
EA ./textures/east.xpm
F 0,128,255
C 255,0,128

1111
1N01
1001
1111

NO ./another.xpm
