NO ./textures/north.xpm
SO ./textures/south.xpm
WE ./textures/west.xpm
EA ./textures/east.xpm

F  0,0,0
C  255,255,255

11111111
1000  01
10  N 01
1000  01
11111111