NO textures/NO.xpm
SO textures/SO.xpm

F 164,169,20

WE                  textures/WE.xpm

                        EA textures/EA.xpm

C 153,204,255


 111
 1N01111111111
 11111111111
 11111
 10001                                                
 11111
 111101
 1  11111
  