NO textures/NO.xpm
SO textures/SO.xpm

F 164,169,20

WE                  textures/WE.xpm

                        EA textures/EA.xpm

C 153,204,255

11111111
100N0001
10000001
10100001
10000001
11111111
