NO textures/simonkraft/wet_sponge.xpm
SO textures/simonkraft/wet_sponge.xpm
WE textures/simonkraft/wet_sponge.xpm
EA textures/simonkraft/wet_sponge.xpm

F 164,169,20
C 153,204,255

1111  
1N01111111111111111111
11111111111111
1001                                                
111111
111101
111111   
