NO textures/simonkraft/wet_sponge.xpm
SO textures/simonkraft/wet_sponge.xpm
WE textures/simonkraft/wet_sponge.xpm
EA textures/simonkraft/wet_sponge.xpm

F 164,169,20
C 153,204,255

11111
10N11                 
11111                          
1
1
1
1
11111111111111111111111111111111111111111111111
100000000000000000000000000001     100000000001
11111111111111111111111111111111111011111111111
100000000000000000000000000000000000011101    11111
11111111111111111111111111111111111111111111111111