NO ./path_to_the_north_texture
SO ./path_to_the_south_textureSO ./path_to_the_south_texture
WE ./path_to_the_west_textureWE ./path_to_the_west_texture
EA ./path_to_the_east_textureEA ./path_to_the_east_texture

F 220,100,0F 220,100,0
C 225,30,0C 225,30,0

11111111111111111111111111111111111111111111111111
10000000001100000000000011000000000110000000000001
10110000011100000000000011011000001110000000000001
10010000000000000000000011001000000000000000000001
111111111011000001110000000000001111111111011000001110000000000001
100000000011000001110111111111111100000000011000001110111111111111
1111011111111101110000001000111110111111111011100000010001
1111011111111101110101001000111110111111111011101010010001
1100000011010101110000001000111000000110101011100000010001
1000000000000000110000001000110000000000000001100000010001
1000000000000000110101001000110000000000000001101010010001
11000001110101011111011110N011111000001110101011111011110N0111
11110111 1110101 10111101000111110111 1110101 101111010001
11111111 1111111 11111111111111111111 1111111 111111111111
